NO ./textures/eagle.xpm
SO ./textures/eagle.xpm
EA ./textures/eagle.xpm
WE ./textures/eagle.xpm


F 157,134,98
C 98,157,104

11111111111111111111
10000000000000000001
10000000000000000001
10000000000000000001
10000000000000000001
1000000000000N000001
10000000000000000001
10000000000000000001
11111111111111111111