NO north
SU south
WE west
EA east
F fco
C cco

111111
100101
101001
110001
111111